--{##########}------
--[..a.......]------
--[.....d....]------
{#;..........<#####}
[**......s...******]
[**.@........******]
[**......d...******]
(+:.......a..>+++++)
--[..a.......]------
--[......f...]------
--[..........]------
--(++++++++++)------