--{##########}--
--[..........]--
--[.x...x....]--
{#;..........<#}
[**......c...*.]
[**.@........*%]
[**..........*.]
(+:..........>+)
--[..z....z..]--
--[..v..v....]--
--[..........]--
--(++++++++++)--