--{##########}------
--[..z.......]------
--[.....c....]------
{#;..........<#####}
[**......z...******]
[**.@........******]
[**.......v..******]
(+:..........>+++++)
--[..c.......]------
--[......c...]------
--[..........]------
--(++++++++++)------