--{##########}--
--[..........]--
--[.o...!....]--
{#;..........<#}
[**......&...*.]
[**.@........*%]
[**..........*.]
(+:..........>+)
--[..$....o..]--
--[.....!....]--
--[..........]--
--(++++++++++)--