--{##########}------
--[..$.......]------
--[.....!....]------
{#;..........<#####}
[**......&...******]
[**.@........******]
[**..........******]
(+:..........>+++++)
--[..o.......]------
--[......$...]------
--[..........]------
--(++++++++++)------